200 16
---------------------------------------------------------------------------------------------------------------------------?----------------------------?-------------------------------?---------------
-----------------------------------------------------------------------------------------?--------------------------------------------------------------------------------------------------------------
----------------------------?--------------------------?--------------------------------------------?----------------------------------------?------------------------------?---------------------------
----------------------------------------------------------------------------------------------------------------------?-----------------------------------?---------------------------------------------
-----------------------------------------------------------------------?-------?----------------------------------------------------------------?-------------------------------------------------------
-----?----------------------------------?------------------------------------------------------------------?--------------------------------------------------------------------------------------------
----------------------------------------------------------?----------------------------------------------------------------------------?------------------------------?-----------?---------------------
------------------------------------------------------------------------------------------?-------------------------------------------------------------------------------------------------------------
--------------------------------------------?----------------------------------------------------------------------------?-------------------------------------?----------------------------------------
-------?------------------------------------------------------------------------?-----------------------------------------------------------------------------------------------------------------------
--P--------------------------?-----------------------------------?-------------------------------------------?----------------------------------------------------------?---------------------?---------
--------------------------------------------------------------------------------------------------------------------------------------------?-----------------------------------------------------------
---------------------------------------------------------------------------------------------?--------------------------?-------------------------------------------------------------------------------
---------------------------------------------------?--------------------?-------------------------------------------------------------------------------?-----------------------------?-----------------
---------------------------------------?-------------------------------------------------------------------------------------------?----------------------------?---------------------------------------
========================================================================================================================================================================================================